WWWWWWWWWWWWWWWWWWWWWWWWWWWWWW
WWWWWWW......WWWWWWWWWWWWWWWWW
WWWWWWW.E....WWWWWWWWWWWWWWWWW
WWWWWWW......WWWWWWWWWWWWWWWWW
WWWWWWW......WWWWWWWWWWWWWWWWW
WWWWWWW......WWWWWWWWWWWWWWWWW
WWWWWWW......WWWWWWWWWWWWWWWWW
WWWWWWWWW...WWWWWWWWWWWWWWWWWW
WWWWWWWWW...WWWWWW.........WWW
WWWWWWWWW...WWWWWW.P.......WWW
WWWWWWWWW..................WWW
WWWW......E................WWW
WWWW..........WWWWWWWWWWWWWWWW
WWWW..........WWWWWWWWWWWWWWWW
WWWW..........WWWWWWWWWWWWWWWW
WWWW..........WWWWWWWWWWWWWWWW
WWWWWWWWWWWWWWWWWWWWWWWWWWWWWW
WWWWWWWWWWWWWWWWWWWWWWWWWWWWWW
WWWWWWWWWWWWWWWWWWWWWWWWWWWWWW
WWWWWWWWWWWWWWWWWWWWWWWWWWWWWW
