WWWWWWWWWWWWWWWWWWWWWWWWWWWWWW
WWWWWWWWWWWW.........WWWWWWWWW
WWWWWWWWWWWW.E.......WWWWWWWWW
WWWWWWWWWWWW.........WWWWWWWWW
WWWWWWWWWWWW.........WWWWWWWWW
WWWWWWWWWWWW.........WWWWWWWWW
WWWWWWWWWWWWWWWW..WWWWWWWWWWWW
WWWWW.....WWWWWW..WWWWWWWWWWWW
WWWWW.P...WWW.........WWWWWWWW
WWWWW.....WWW.E.......WWWWWWWW
WWWWW.................WWWWWWWW
WWWWW.................WWWWWWWW
WWWWW.....WWW.........WWWWWWWW
WWWWWWWWWWWWW.........WWWWWWWW
WWWWWWWWWWWWWWWWWWWWWWWWWWWWWW
WWWWWWWWWWWWWWWWWWWWWWWWWWWWWW
WWWWWWWWWWWWWWWWWWWWWWWWWWWWWW
WWWWWWWWWWWWWWWWWWWWWWWWWWWWWW
WWWWWWWWWWWWWWWWWWWWWWWWWWWWWW
WWWWWWWWWWWWWWWWWWWWWWWWWWWWWW
