WWWWWWWWWWWWWWWWWWWWWWWWWWWWWW
WWWWWWWWWWWWWWWWWWWWWWWWWWWWWW
WWWWWWWWWWWWWWWWWWWWWWWWWWWWWW
WWWWWWWWWWWWWWWW......WWWWWWWW
WWWWWWWWWWWWWWWW.E....WWWWWWWW
WWWWWWWWWWWWWWWW......WWWWWWWW
WWWWWWW...............WWWWWWWW
WWWWWWW.P.............WWWWWWWW
WWWWWWW...............WWWWWWWW
WWWWWWW...............WWWWWWWW
WWWWWWWWWWWWW..WWWWWWWWWWWWWWW
WWWWWWWWWWWWW..WWWWWWWWWWWWWWW
WWWWWWWWWWWWW..WWWWWWWWWWWWWWW
WWWWWWWWW.........WWWWWWWWWWWW
WWWWWWWWW.E.......WWWWWWWWWWWW
WWWWWWWWW.........WWWWWWWWWWWW
WWWWWWWWW.........WWWWWWWWWWWW
WWWWWWWWWWWWWWWWWWWWWWWWWWWWWW
WWWWWWWWWWWWWWWWWWWWWWWWWWWWWW
WWWWWWWWWWWWWWWWWWWWWWWWWWWWWW
