WWWWWWWWWWWWWWWWWWWWWWWWWWWWWW
WWWWWWWWWWWWWWWWWWWWWWWWWWWWWW
WWWWWWWWWWWWWWWWWWWWWWWWWWWWWW
WWWWWWWWWWWWWWWWWWWWWWWWWWWWWW
WWWWWWWWWWWWWWWWWWWWWWWWWWWWWW
WWWWWWWWWWWWWWWWWWWWWWWWWWWWWW
WWWWWWWWWW......WWWWWWWWWWWWWW
WWWWWWWWWW.E....WWWWWWWWWWWWWW
WWWWWWWWWW......WWWWWWWWWWWWWW
WW.....WWW......WWWWWWWWWWWWWW
WW.P...WWW......WWWWWWWWWWWWWW
WW......................WWWWWW
WW.......................WWWWW
WWWWWWWWWWWWW..WWWW.E......WWW
WWWWWWWWWWW.....WWW........WWW
WWWWWWWWWWW.E..............WWW
WWWWWWWWWWW................WWW
WWWWWWWWWWW.....WWWWWWWWWWWWWW
WWWWWWWWWWWWWWWWWWWWWWWWWWWWWW
WWWWWWWWWWWWWWWWWWWWWWWWWWWWWW
