WWWWWWWWWWWWWWWWWWWWWWWWWWWWWW
WWWWWWWWWWWWWWW.......WWWWWWWW
WWWWWWWWWWWWWWW.E.....WWWWWWWW
WWWWWWWWWWWWWWW.......WWWWWWWW
WWWWWWWWWWWWWWW.......WWWWWWWW
WWWWWWWWWWWWWWW.......WWWWWWWW
WWWWWWWWWWWWWWWWWW..WWWWWWWWWW
WWWW......WWWWWWWW..WWWWWWWWWW
WWWW.E....WWWWWW.........WWWWW
WWWW......WWWWWW.P.......WWWWW
WWWW.....................WWWWW
WWWW.....................WWWWW
WWWW.....................WWWWW
WWWW......WWWWWW.........WWWWW
WWWWWWWWWWWWWWWWWWWWWWWWWWWWWW
WWWWWWWWWWWWWWWWWWWWWWWWWWWWWW
WWWWWWWWWWWWWWWWWWWWWWWWWWWWWW
WWWWWWWWWWWWWWWWWWWWWWWWWWWWWW
WWWWWWWWWWWWWWWWWWWWWWWWWWWWWW
WWWWWWWWWWWWWWWWWWWWWWWWWWWWWW
