WWWWWWWWWWWWWWWWWWWWWWWWWWWWWW
WWWWWWWWWWWWWWW......WWWWWWWWW
WWWWWWWWWWWWWWW.E....WWWWWWWWW
WWWWWWWWWWWWWWW......WWWWWWWWW
WWWWWWWWWWWWWWW......WWWWWWWWW
WWWWWWWWWWWWWWW......WWWWWWWWW
WW.......WWWWWW......WWWWWWWWW
WW.P.....WWWWWWWWW..WWWWWWWWWW
WW.......WWWWWWWWW..WWWWWWWWWW
WW..................WWWWWWWWWW
WW...............E.....WWWWWWW
WW.......WWWWWWW.......WWWWWWW
WW.......WWWWWWW.......WWWWWWW
WWWWWWWWWWWWWWWW.......WWWWWWW
WWWWWWWWWWWWWWWWWWWWWWWWWWWWWW
WWWWWWWWWWWWWWWWWWWWWWWWWWWWWW
WWWWWWWWWWWWWWWWWWWWWWWWWWWWWW
WWWWWWWWWWWWWWWWWWWWWWWWWWWWWW
WWWWWWWWWWWWWWWWWWWWWWWWWWWWWW
WWWWWWWWWWWWWWWWWWWWWWWWWWWWWW
