WWWWWWWWWWWWWWWWWWWWWWWWWWWWWW
W........WWWWWWWWWWWWWWWWWWWWW
W.E......WWWWWWWWWWWWWWWWWWWWW
W........WWWWWWW.......WWWWWWW
W........WWWWWWW.E.....WWWWWWW
WWW....................WWWWWWW
WWW....................WWWWWWW
WWW....WWWWWWWWWWWW..WWWWWWWWW
WWW....WWWWWWWWWWWW..WWWWWWWWW
WWW....WWWWWWW.......WWWWWWWWW
W...E..WWWWWWW.P.....WWWWWWWWW
W......WWWWWWW......WWWWWWWWWW
W.....WWWWWWWW......WWWWWWWWWW
W.....WWWWWWWWWWWWWWWWWWWWWWWW
WWWWWWWWWWWWWWWWWWWWWWWWWWWWWW
WWWWWWWWWWWWWWWWWWWWWWWWWWWWWW
WWWWWWWWWWWWWWWWWWWWWWWWWWWWWW
WWWWWWWWWWWWWWWWWWWWWWWWWWWWWW
WWWWWWWWWWWWWWWWWWWWWWWWWWWWWW
WWWWWWWWWWWWWWWWWWWWWWWWWWWWWW
